NO  ./textures/NO.xpm
SO  ./textures/SO.xpm
WE  ./textures/WE.xpm
EA  ./textures/EA.xpm


C  25, 25 , 30
F 220, 100 ,  1

        
         
111
1N1
101
101 
11111
11
1





        
  